111111111111111111111111111111111111111111111111111111111
1000CCC00000000000000000000001000000000000X00000000E00001
1000000000000x000000000000CCCCCCCCCCC00000000000000000001
100000000011111111111111111111111111111111111111111100001
1000000000000000000X0000000000000000000X00000000000000001
100001111000111000011100011100011100000000001110001110001
1111110CC1110CC01110CC1110CC1110C011100001110C01110C01111
10000000000000000000000X000000000000000000000000000000001
1010P1001001001001001001001001001001001001001001001001001
111111111111111111111111111111111111111111111111111111111